COLUMN_NAME	DATA_TYPe
Codigo	int
CodVenda	int
ChaveNFe	varchar
XMLTexto	text
Status	char
DataCriacao	datetime
Num_Serie	int
Num_Nota_Fiscal	int
Valor	float
Motivo	int
CodNota	int
Tipo_Amb	int
CodEmitente	int
Exportada	varchar
Exportado	varchar
Forma_Emissao	int
ST_Situacao	int
ST_Retorno	varchar
XMLCancelamento	xml
DEPEC	int
XML_INU	xml
PROTOCOLO	varchar
PROTOCOLO_CAN	varchar
PROTOCOLO_INU	varchar