CodNota	int
XMLChave	varchar
NumNota	int
Serie	char
DataGeracao	datetime
DataTransmissao	datetime
DataCancelamento	datetime
DataInutilizacao	datetime
XMLGeracao	text
XMLTransmissao	text
XMLCancelamento	text
Status	varchar
Tipo_Amb	int
Data_Emissao	datetime
CodEmitente	int
Dest_Cod_Cli_Forn	int
Num_Mod_Doc	int
Pedido	int
Num_Serie	int
Valor	float
Motivo	int
Exportada	varchar
Exportado	varchar
CFOP	int
XMLInutilizacao	varchar
RejeicaoMotivo	varchar
ST_Retorno	int
Data_Rejeicao	datetime
Rejeicao	varchar
chavecorreta   varchar